6 5 2 5 2 5 2 5 2 5 2 5 2 5 2 5 2 5 2 6
4 14 9 12 14 9 12 14 9 12 14 9 12 14 9 6 14 9 12 4
4 14 7 7 9 12 14 6 9 14 9 12 14 9 12 6 14 9 12 4
4 9 7 7 12 14 9 6 6 6 6 6 6 6 14 6 9 12 14 4
4 12 14 9 12 6 9 6 12 9 14 12 14 9 12 6 14 9 12 4
4 9 12 14 9 6 14 6 9 14 13 13 12 14 9 6 12 14 9 4
4 12 14 9 6 14 9 6 14 12 13 13 9 14 6 9 9 12 14 4
4 14 9 6 14 9 12 6 6 6 6 6 9 6 6 14 12 14 9 4
4 6 6 14 9 12 14 6 12 9 14 12 14 6 12 14 14 9 12 4
4 12 14 9 12 14 9 6 14 14 0 7 14 14 14 14 9 12 14 4
4 9 12 14 9 12 14 6 9 14 10 9 12 6 9 14 12 14 9 4
4 12 14 9 12 14 9 6 14 9 14 12 14 9 6 6 6 6 6 4
4 14 9 12 14 9 6 12 9 14 12 14 9 12 14 14 12 14 9 4
4 9 12 14 9 6 14 14 12 9 14 12 14 9 12 14 14 9 12 4
4 6 6 6 6 14 12 14 14 12 14 9 12 14 6 6 6 6 6 4
4 14 9 12 14 9 12 6 14 14 14 14 13 6 14 14 7 7 9 4
4 9 12 14 9 12 14 6 9 14 9 6 6 14 14 14 12 14 9 4
4 12 14 9 12 14 9 6 12 9 12 6 9 14 9 14 14 12 14 4
4 14 9 12 14 9 12 6 9 14 12 9 14 12 14 14 12 14 9 4
4 5 2 5 2 5 2 5 2 5 2 5 2 5 2 5 2 5 2 4
