3 0 0 1 1 1 1 1 1 1 1 1 1 1 1 4
5 0 0 0 0 0 0 0 0 0 0 0 0 0 0 6
5 0 0 0 0 0 0 0 0 0 0 0 0 0 0 6
5 0 0 0 0 0 0 0 0 0 0 0 0 0 0 6
5 0 0 0 0 0 0 0 0 0 0 0 0 0 0 6
5 0 0 0 0 0 0 0 0 0 0 0 0 0 0 6
5 0 0 0 0 0 0 0 0 0 0 0 0 0 0 6
5 0 0 0 0 0 0 0 0 0 0 0 0 0 0 6
5 0 0 0 0 0 0 0 0 0 0 0 0 0 0 6
5 0 0 0 0 0 0 0 0 0 0 0 0 0 0 6
5 0 0 0 0 0 0 0 0 0 0 0 0 0 0 6
2 1 1 1 1 1 1 1 1 1 1 1 1 1 1 7